0000000000000000000000000
0000000000000000000000000
0000000000000000000000000
0000000000000000000000000
0000000000000000000000000
0000000000000000000000000
0000000000000000000000000
0000000000000000000000000
0000000000000000000000000
0000000000000000000000000
0000000000000000000000000
0000000000000000000000000
0000000000000000000000000
0000000000000000000000000
0000000000000000000000000
0010000000000000000000000
0000000000000000000000000
0000000000000000000000000
0000000000000000000000000

WWWWWWWWWWWWWWWWWWWWWWWWW
W00000000000000000000000W
W00000000000000000000000W
W00000000000000000000000W
W00000000000000000000000W
W00000000000000000000000W
W00000000000000000000000W
W00000000000000000000000W
W00000000000000000000000W
W00000000000000000000000W
W00000000000000000000000W
W00000000000000000000000W
W00000000000000000000000W
W00000000000000000000000W
W00000000000000000000000W
W00000000000000000000000W
W00000000000000000000000W
W00000000000000000000000W
WWWWWWWWWWWWWWWWWWWWWWWWW

0000000000000000000000000
0000000000000000000000000
0000000000000000000000000
0000000000000000000000000
0000000000000000000000000
0000000000000000000000000
0000000000000000000000000
0000000000000000000000000
0000000000000000000000000
0000000000000000000000000
0000000000000000000000000
0000000000000000000000000
0000000000000000000000000
0000000000000000000000000
0000000000000000000000000
0000000000000000000000000
0000000000000000000000000
W00000000000000000000000W
WWWWWWWWWWWWWWWWWWWWWWWWW